101
100
AAAAAAAAAAAAAAAAAAAAAAAAAAAAAAAAAAAAAAAAAAAAAAAAAAAAAAAAAAAAAAAAAAAAAAAAAAAAAAAAAAAAAAAAAAAAAAAAAAAA
AAAAAAAAAAAAAAAAAAAAAAAAAAAAAAAAAAAAAAAAAAAAAAAAAAAAAAAAAAAAAAAAAAAAAAAAAAAAAAAAAAAAAAAAAAAAAAAAAAAA
AA__AA____________________________________________________________________________________________AA
AA__AA_____.......________________________________________________________________________________AA
AA_________._____.________________________________________________________________________________AA
AA_........._____.________________________________________________________________________________AA
AA_______________.________________________________________________________________________________AA
AA______________..________________________________________________________________________________AA
AA______________._________________________________________________________________________________AA
AA______________._________________________________________________________________________________AA
AA______________._________________________________________________________________________________AA
AA______________._________________________________________________________________________________AA
AA______WWWWW___....._____________________________________________________________________________AA
AA_____WWWWWWW______._____________________________________________________________________________AA
AA____WWWWWWWWW_____._____________________________________________________________________________AA
AA____WWWWWWWWWW____......________________________________________________________________________AA
AA___WWWWWWWWWWWW________.________________________________________________________________________AA
AA___WWWWWWWWWWWW________.________________________________________________________________________AA
AA____WWWWWWWWW__________.________________________________________________________________________AA
AA_____WWWWWWW___________.________________________________________________________________________AA
AA______WWWWW_____________________________________________________________________________________AA
AA________________________________________________________________________________________________AA
AA________________________________________________________________________________________________AA
AA________________________________________________________________________________________________AA
AA________________________________________________________________________________________________AA
AA________________________________________________________________________________________________AA
AA________________________________________________________________________________________________AA
AA________________________________________________________________________________________________AA
AA________________________________________________________________________________________________AA
AA________________________________________________________________________________________________AA
AA________________________________________________________________________________________________AA
AA________________________________________________________________________________________________AA
AA________________________________________________________________________________________________AA
AA________________________________________________________________________________________________AA
AA________________________________________________________________________________________________AA
AA________________________________________________________________________________________________AA
AA________________________________________________________________________________________________AA
AA________________________________________________________________________________________________AA
AA________________________________________________________________________________________________AA
AA________________________________________________________________________________________________AA
AA________________________________________________________________________________________________AA
AA________________________________________________________________________________________________AA
AA________________________________________________________________________________________________AA
AA________________________________________________________________________________________________AA
AA________________________________________________________________________________________________AA
AA________________________________________________________________________________________________AA
AA________________________________________________________________________________________________AA
AA________________________________________________________________________________________________AA
AA________________________________________________________________________________________________AA
AA________________________________________________________________________________________________AA
AA________________________________________________________________________________________________AA
AA________________________________________________________________________________________________AA
AA________________________________________________________________________________________________AA
AA________________________________________________________________________________________________AA
AA________________________________________________________________________________________________AA
AA________________________________________________________________________________________________AA
AA________________________________________________________________________________________________AA
AA________________________________________________________________________________________________AA
AA________________________________________________________________________________________________AA
AA________________________________________________________________________________________________AA
AA________________________________________________________________________________________________AA
AA________________________________________________________________________________________________AA
AA________________________________________________________________________________________________AA
AA________________________________________________________________________________________________AA
AA________________________________________________________________________________________________AA
AA________________________________________________________________________________________________AA
AA________________________________________________________________________________________________AA
AA________________________________________________________________________________________________AA
AA________________________________________________________________________________________________AA
AA________________________________________________________________________________________________AA
AA________________________________________________________________________________________________AA
AA________________________________________________________________________________________________AA
AA________________________________________________________________________________________________AA
AA________________________________________________________________________________________________AA
AA________________________________________________________________________________________________AA
AA________________________________________________________________________________________________AA
AA________________________________________________________________________________________________AA
AA________________________________________________________________________________________________AA
AA________________________________________________________________________________________________AA
AA________________________________________________________________________________________________AA
AA________________________________________________________________________________________________AA
AA________________________________________________________________________________________________AA
AA________________________________________________________________________________________________AA
AA________________________________________________________________________________________________AA
AA________________________________________________________________________________________________AA
AA________________________________________________________________________________________________AA
AA________________________________________________________________________________________________AA
AA________________________________________________________________________________________________AA
AA________________________________________________________________________________________________AA
AA________________________________________________________________________________________________AA
AA________________________________________________________________________________________________AA
AA________________________________________________________________________________________________AA
AA________________________________________________________________________________________________AA
AA________________________________________________________________________________________________AA
AA________________________________________________________________________________________________AA
AA________________________________________________________________________________________________AA
AA________________________________________________________________________________________________AA
AA________________________________________________________________________________________________AA
AAAAAAAAAAAAAAAAAAAAAAAAAAAAAAAAAAAAAAAAAAAAAAAAAAAAAAAAAAAAAAAAAAAAAAAAAAAAAAAAAAAAAAAAAAAAAAAAAAAA
AAAAAAAAAAAAAAAAAAAAAAAAAAAAAAAAAAAAAAAAAAAAAAAAAAAAAAAAAAAAAAAAAAAAAAAAAAAAAAAAAAAAAAAAAAAAAAAAAAAA
